#,#,#,#,#,#,#
#, , , , ,F,#
#,S, , , , ,#
#, , , , ,F,#
#,#,#,#,#,#,#
