#######
#    F#
#S    #
#    F#
#######
