#,#,#,#,#,#,#,#
#, , , , , ,S,#
#, , , , , , ,#
#, , , , , , ,#
#,F, , , , , ,#
#,#,#,#,#,#,#,#