########
#     S#
#      #
#      #
#F     #
########