#,#,#,#,#,#,#,#
#, , , , , ,S,#
#, ,#,#,#,#,#,#
#, , , , , ,F,#
#,#,#,#,#,#,#,#