#,#,#,#,#,#,#,#
#, , , , , ,S,#
#, , , , ,#,#,#
#, , , , ,#, ,#
#, , , , , ,F,#
#,#,#,#,#,#,#,#