########
#     S#
# ######
#     F#
########