##############################
#S#   #   #   #   #   #   #  #
# # # # # # # # # # # # # #  #
# # # # # # # # # # # # # #  #
# # # # # # # # # # # # # #  #
#   #   #   #   #   #   #   F#
##############################