#,#,#,#,#,#,#,#
#, , , , , ,S,#
#, ,#,#,#,#,#,#
#, , , , , , ,#
#,#,#,#,#,#, ,#
#,F, , , , , ,#
#,#,#,#,#,#,#,#