########
#     S#
# ######
#      #
###### #
#F     #
########