#,#,#,#,#,#,#,#,#,#
#,S, , , , , , , ,#
#,#,#,#,#,#,#,#, ,#
#, , , , , , , , ,#
#, ,#,#,#,#,#,#,#,#
#, , , , , , , ,F,#
#,#,#,#,#,#,#,#,#,#