##########
#S       #
######## #
#        #
# ########
#       F#
##########