#,#,#,#,#,##,#,#,#
#,S,#, , , #, , ,#
#, ,#, ,#, #, , ,#
#, ,#, ,#, #, , ,#
#, ,#, ,#, #, , ,#
#, , , ,#,  , ,F,#
#,#,#,#,#,##,#,#,#