##########
#S#   #  #
# # # #  #
# # # #  #
# # # #  #
#   #   F#
##########