##################
#          #     #
# # #### # #  #  #
# # # S# # #  #  #
# # # ## # #  #  #
# # #    # #  #  #
# # ###### #  #  #
# #        #  #  #
# ##########  #  #
#             # F#
##################