#,#,#,#,#,#,#,#,#,#
#,F, , , , , ,#,F,#
#,#,#,#,#,#, ,#, ,#
#, , ,S, ,#, ,#, ,#
#, , , , ,#, ,#, ,#
#,#,#,#, ,#, ,#, ,#
#, , , , , , , , ,#
#,#,#,#,#,#,#,#, ,#
#,F, , , , , , , ,#
#,#,#,#,#,#,#,#,#,#
