##########
#F     #F#
###### # #
#  S # # #
#    # # #
#### # # #
#        #
######## #
#F       #
##########
