#,#,#,#,#,#,#,#,#,#,#,#,#,#,#,#,#,#,#,#,#
#,S,#, , , ,#, , , , , , , ,#, , , , , ,#
#, ,#, ,#, ,#, ,#, ,#,#,#, ,#,#,#, ,#, ,#
#, ,#, ,#, , , ,#, , , ,#, , , , , ,#, ,#
#, ,#,#,#,#,#, ,#,#,#, ,#,#,#,#,#,#,#, ,#
#, , , , , ,#, , , ,#, , , ,#, , , , , ,#
#,#,#,#,#, ,#,#,#,#,#, ,#, ,#, ,#,#,#,#,#
#, , , ,#, ,#, , , ,#, ,#, ,#, ,#, , , ,#
#, ,#, ,#, ,#, ,#, ,#,#,#, ,#, ,#, ,#, ,#
#, ,#, ,#, , , ,#, , , ,#, ,#, ,#, ,#, ,#
#, ,#, ,#,#,#,#,#,#,#, ,#, ,#, ,#,#,#, ,#
#, ,#, ,#, , , , , ,#, ,#, ,#, , , , , ,#
#, ,#, ,#, ,#,#,#, ,#, ,#, ,#,#,#,#,#,#,#
#, ,#, , , ,#, ,#, ,#, ,#, , , , , , , ,#
#, ,#,#,#,#,#, ,#, ,#, ,#, ,#,#,#,#,#, ,#
#, ,#, , , , , ,#, ,#, ,#, ,#, , , ,#, ,#
#, ,#, ,#,#,#,#,#, ,#, ,#,#,#, ,#, ,#, ,#
#, , , ,#, , , , , ,#, , , , , ,#, , , ,#
#,#,#, ,#, ,#,#,#,#,#,#,#,#,#,#,#,#,#, ,#
#, , , ,#, , , , , , , , , , , , , , ,F,#
#,#,#,#,#,#,#,#,#,#,#,#,#,#,#,#,#,#,#,#,#
