#####################
#S#   #       #     #
# # # # # ### ### # #
# # #   #   #     # #
# ##### ### ####### #
#     #   #   #     #
##### ##### # # #####
#   # #   # # # #   #
# # # # # ### # # # #
# # #   #   # # # # #
# # ####### # # ### #
# # #     # # #     #
# # # ### # # #######
# #   # # # #       #
# ##### # # # ##### #
# #     # # # #   # #
# # ##### # ### # # #
#   #     #     #   #
### # ############# #
#   #              F#
#####################
