##############################
#S                           #
############################ #
#                            #
# ############################
#                           F#
##############################