##############################
#        ############        #
#        #          #  ####  #
#        # # #### # #  ####  #
#        # # # S# # #  ####  #
#        # # # ## # #  ####  #
#        # # #    # #  ####  #
#        # # ###### #  ####  #
#        # #        #  ####  #
#        # ##########  ####  #
#        #             #### F#
##############################