#,#,#,#,#,#,#,#,#,#
#,F,,,,,,#,,#
#,#,#,#,#,#,,#,,#
#,,,S,,#,,#,,#
#,,,,,#,,#,,#
#,#,#,#,,#,,#,,#
#,,,,,,,,,#
#,#,#,#,#,#,#,#,,#
#,,,,,,,,,#
#,#,#,#,#,#,#,#,#,#
